-20
22
-11
14
0000000000000000000000000000000000000000000
1111111111111111111111111111111111111111110
0000000000000000000000000000000000000000000
0000000000000000000000000000000000000000000
0000000000000000000000000000000000000000000
0000000000000000000000000000000000000000000
0000000000000000000000000000000000000000000
0000000000000000000000000000000000000000000
0000000000000000000000000000000000000000000
0000000000000000000000000000000000000000000
0000000000000000000000000000000000000000000
0000000000000000000000000000000011000000000
0000000000000000000000000011111110000000000
0000000000001000000000000011111110000000000
0000000000000000000000000011111110000000000
0000000000000100000000000011111110000000000
0000000000000000000000000011111110000000000
0000000000000000000000000011111110000000000
0000000000000000000000000011111110000000000
0000000000000000000000000000000000000000000
0000000000000000000000000000000000000000000
0000000000000000000000000000000000000000000
0000000000000000000000000000000000000000000
0000000000000000000000000000000000000000000
0000000000000000000000000000000000000000000
0000000000000000000000000000000000000000000
