-8
14
-4
4
00000000000000000000000
00000000000000000000110
00000000000000111111100
10000000000000111111100
00000000000000111111100
01000000000000111111100
00000000000000111111100
00000000000000111111100
00000000000000111111100
